111111
10E011
111001
1CP011
111111
