1111111111111111
111010000E0CP111
1100010000000011
100000100C000001
100C000100000001
110000C010000011
1110000000000111
1111111111111111
