1111111111111111
111000000E0CP111
1100000000000011
1000000000000001
1000000000000001
1000000000000001
1000000000000001
1000000000000001
110000C000000011
1110000000000111
1111111111111111
